20,5,32,32,1,16
0,0,0,0,0,0,0,0,0,0,0,0,0,0,0,0,0,0,0,0
0,0,0,0,0,0,0,0,0,0,0,0,0,0,0,0,0,0,0,0
7,8,9,7,8,9,7,8,9,7,8,9,7,8,9,7,8,9,7,8
28,29,30,28,29,30,28,29,30,28,29,30,28,29,30,28,29,30,28,29
28,29,30,28,29,30,28,29,30,28,29,30,28,29,30,28,29,30,28,29

